%%%%%%%%%
%.      %
% G     %
%       %
%   P   %
%       %
%       %
%       %
%%%%%%%%%