%%%%%%%%%%%%%%%%%%%
%                 %
%                 %
%                 %
%  GGGGGGGGGGGGG  %
% %%%%%%%%%%%%%%% %
%P%             %.%
%%%             %%%