%%%%%%%%%%%%%%%%%%%%%%%
%                     %
%                     %
%                     %
%    GGGGGGGGGGGGG    %
%   %%%%%%%%%%%%%%%   %
% P %%%%%%%%%%%%%%% . %
%%%%%%%%%%%%%%%%%%%%%%%