%%%%%%%%%
%.%   %P%
% % % % %
% % % % %
%   %   %
%%%%%%%%%
